C C C C C C C C C C C D A A A A A A A A
C C C C C C C C C C C D A A A A A A A A
C C C/S C C C C C C C C D D A A A A A A A
C C C C C C C C C C C C D D A A A A A A
C/S C C C C C C C C C C C C D D D A A A A
C C C C C C C C C C C C C C C D D D D D
C C C C C/S C C C C C C C C C C C C C C C
C C C C C C C C C C C C C C C C/S C C C C
C C C C C C C C C C C C C C C C C C C C
C C C C C C C C C C C C C C C C C C C C
C C C C C C C C C C C C C C C C C C C C
C C C C C C C C C C C C C C C C C C C C
B B C C C C C C C C C C C C C C C C C C
W B B C C C C C/S C C C C C C C C C C C C
W W B C C C C C C C C C C C C C C C B B
W W B B B C C C C C C C C C C B B B B L
W W W W B B C C C C C C C C B B L L L L
W W W W W B C C C C C C C B B L L L L L
W W W W W B B C C C C C C B L L L L L L
W W W W W W B C C C C C C B L L L L L L